################             ######
#..............###############~~~~###
#....~~~~~.....#..............~~~~..#
#.....~~~~....................~~~~..#
#......~~~~...................~~~~..#
#......######..########.....~~~~~...#
#......#..~.#..#      #.....~~~~~...#
#...........#..#      #.............#
################      ###############
